NO ./assets/north_wall.xpm
WE ./assets/west_wall.xpm
EA ./assets/east_wall.xpm
SO ./assets/south_wall.xpm
DO ./assets/door.xpm

C 135,206,235
F 128,128,128

1111111111111111111111
1001000000000000000D01
100D000000000000000101
1001000000000000000101
1D11000000011111111101
1000000000010000000101
10000E00000D0000000101
1000000000010000000101
1000000000010000000101
1000000000011111111101
11D1111111110000000101
1000000000010000000101
10000000000D0000000D01
1000000000010000000101
1111111111111111111111
